NO textures/hetler.xpm
SO textures/soviat.xpm
WE textures/hetler_face.xpm
EA textures/666.xpm

C 64,1,232
F 109,64,37

11111111111111111111111111
11100000000000000000100001        111111111111111
1111100000000100111011111111111111100000000000001
1111000011111000001000000000000000000000010000001
1111111100000000011111111111111111110000000000001
       10000000001111               1000000000001
111111110000000011111               1111111111111
1111111110000011111111
1111    1000001  1111
        1000001      
        1000001      
        1000001      
        1100011      
        1000001      
        1000001      
        1000001      
        1000001            
11111111111D111111111111111111111
100111100000000000000000000000011
100000000000000000000000011111111
1000000000000000000000001111111
100000N00000000000000000111111111
100000000000000000000000111111111
11111111111111111111111111

