NO textures/text1
SO textures/text2
WE textures/text3
EA textures/text4

C 225,30,6
F 220,100,1

11111111111   1111111111111111111111111
1111110111111111111111111
100N00000011000000000001
1011000001110000000000001
1001000000000000000000001
111111111011000001110000000000001
10000000001100000111011111111111111
11110111111111011100000010001
111101111111110111010100100011111
11000000110101011100000010001
10000000000000000110000001001
1000000000000000110101001001
11000001110101011111011100111
11111111111111111111111111111111111
11111111111   11111111111  11111111111
