NO textures/text1
SO textures/text2
WE textures/text3
EA textures/text4

C 64,227,232
F 109,64,37

111111111111111111111
111010000111111111111             111111111111111
1111100000000111111011111111111111100000000000001
11110000111110000N1000000000000000000000000000001
1111111100000000011111111111111111110000000000001
       10000000001111               1000000000001
111111110000000011111               1111111111111
111111110000001111111
1111    1000001  1111
        1000001      
        1000001      
        1000001      
        1000001      
        1000001      
        1000001      
        1000001      
        1000001      
11111111000000011111111111
10000000000000000000000001
10000000000000000000000001
11111111111111111111111111