NO textures/text1
SO textures/text2
WE textures/text3
EA textures/text4

C 225,30,1
F 220,100,4

11111111111111111
10111000010000001
10000001000000001
10000000N00000001
10000000000000001
10111000000000001
10000000000000001
11111111111111111