NO textures/hetler.xpm
SO textures/soviat.xpm
WE textures/hetler_face.xpm


EA textures/666.xpm


C 9,64,4
F 109,37,0



11111111111111111111111111
11100000000000000000100001        111111111111111
1111100000000000111011111111111111100000000000001
1111000011111D11101000000000000000000000010000001
1111111100000000011111111111111111110000000000001
       10000000001111               1000000000001
111111110000000011111               1111111111111
1111111110000011111111
1111    1000001  1111
	1000001      
	1000001      
	1000001      
	1100011      
	1000001      
	1000001      
	1000001      
	1000001           
11111111111D111111111111111111111
100111100000000000000000000000011
1000000000000E10000000000011111111
1000010000000101110010001111111
10001000000000111001100111011111
10000000000000011100000111111111
11111111111111111111111111





