NO textures/text1
SO textures/text2
WE textures/text3
EA textures/text4

C 225,30,0
F 220,100,0
11111111111   1111111111111111111111
1111110111111111111111111
100000000011000000000001
1011000001110000000000001
1001000000000000000000001
111111111011000001110000000000001
100000000011000001110111111111111
11110111111111011100000010001
11110111111111011101010010001
11000000110101011100000010001
10000000000000000110000001001
1000000000000000110101001001
110000011101010111110111N0111
11111111111111111111111111111111111
11111111111   11111111111  11111111111
